+-+-+-+-+-+-+-+-+-+-+
|S      |   | |     |
+ +-+-+-+ +-+ +-+ +-+
| |     |   |   |   |
+ + + +-+ +-+-+ + + +
|   |         | | | |
+-+-+-+ +-+ + + + +-+
| |     |   |       |
+ +-+ + + + + +-+-+-+
|   | | | | | |     |
+ +-+ +-+ +-+-+-+ +-+
|     | | | | |     |
+-+-+ + + + + +-+ +-+
|     |     | |     |
+ +-+-+ +-+ + + +-+-+
| |   | |       | | |
+ + +-+-+ + +-+-+ + +
| | | | | |     |   |
+-+ + + + + + +-+ + +
|         | |     |X|
+-+-+-+-+-+-+-+-+-+-+
