+-+-+-+-+-+-+-+-+-+-+
|S  |     | | | |   |
+ +-+-+ +-+ + + + +-+
|         | |     | |
+-+ + + +-+ +-+ +-+ +
|   | | | | | |     |
+-+-+ +-+ + + + +-+-+
| | | |     |       |
+ + + + + +-+ +-+-+-+
|   | | |     |     |
+ +-+ + +-+ +-+-+-+ +
|     | |     | | | |
+ + + + +-+ +-+ + + +
| | |   | |     |   |
+-+-+ +-+ +-+-+ + +-+
| |   |   |   |     |
+ +-+ + +-+ +-+ + +-+
|           |   |   |
+ +-+ +-+ + +-+ +-+ +
|   |   | | |     |X|
+-+-+-+-+-+-+-+-+-+-+
 