+-+-+-+-+-+-+-+-+-+-+-+-+-+-+-+
|S      |   |     |     |     |
+ +-+-+ + + +-+ +-+-+ +-+ + +-+
|     | | |       | |     |   |
+-+-+ + +-+-+ +-+-+ + + + +-+ +
| | | |     |   | | | | | |   |
+ + + +-+ +-+-+ + + + +-+-+-+-+
|       |   |   |   | |   |   |
+ +-+-+ +-+ + +-+ + + +-+ + +-+
| | |   | |       |   | |     |
+ + +-+-+ +-+-+ + +-+-+ + + + +
| |     |       |     |   | | |
+-+ + +-+-+-+ +-+-+ +-+-+-+ +-+
|   |       | | | |       |   |
+ +-+-+ +-+ +-+ + + +-+ +-+-+ +
| |       | |   |   |   |     |
+ +-+-+ +-+-+ +-+ + + + +-+-+ +
| | |       |     | | |       |
+-+ +-+ +-+ +-+-+-+ +-+ + +-+-+
| | | |   | | |     |   | |   |
+ + + + + +-+ + +-+-+-+ +-+ + +
| |   | |         |   |     | |
+ +-+ + +-+-+-+-+-+-+ +-+-+ +-+
| | |   |         |     | | | |
+ + + +-+-+ +-+ + +-+-+ + + + +
|   |   |   | | |         |   |
+ +-+ +-+-+-+ + +-+ + +-+-+ + +
| |   |   |   |   | |     | | |
+ +-+ + +-+-+ +-+ +-+ + + + +-+
|     |             | | |    X|
+-+-+-+-+-+-+-+-+-+-+-+-+-+-+-+
 