+-+-+-+-+-+
|S  | | | |
+-+ + + + +
|   |     |
+-+ + +-+-+
| |       |
+ + + +-+-+
|   |   | |
+-+ + +-+ +
|   |    X|
+-+-+-+-+-+
 