+-+-+-+-+-+
|S|   |   |
+ + + +-+ +
| | | | | |
+ +-+ + + +
| |   |   |
+ + +-+-+ +
|   |     |
+ +-+ +-+-+
|        X|
+-+-+-+-+-+
